............#....#............. 
...........##....#......#..#..#
......#.......#......#.........
..#.#....#....#.............##.
..#........####....#...#.......
..##.....#.#.#..#.........#....
...#.#..#..#....#..#..#........
#.......#.........#....##.###..
......##..#.#...#.......#.#....
................##.........#.##
..##..........#...#.........#.#
..........#...##...............
#...#......#..#.#..#...##..#...
..##....#.......#......#..#....
....#......#......#....#.......
.........#.....#..#............
.#...#.#.........#........#....
#..........####.....#..........
......##.....#....#..#........#
#......#......#...........#....
....#.........#....#...#..#..#.
.#........#......#.#.....#.....
..#.#.#..........#....#.......#
......#.#........##....##....##
.....#.#..#...#................
......#......##...............#
..#..##.............#...##.....
......##......##..#......#.....
....#.............#..##.....##.
........#...............##.....
..#......#.##..#...#....#...#..
#......#.......#.............#.
.....#....##..............#....
#.#.........#....#..##....#....
.#...#...#....#.#............#.
...#...#.#..##.##.......##.....
......#..#....##..#.#..#..#....
.......##..#..#......#..#.....#
.##..#......#..........#....#..
.....#................#..#....#
........#..#....#.......#....#.
..#......#.......#......#....#.
....#...#.##........##....#....
.....#........#...........#....
...#....##..........#..#...#.#.
...#.......#......#...##...#...
.#.....#........#........#.#..#
.#.........#..##.....#.......#.
....#..#....#.......#......#...
.#.#...##..##................##
......#.#...#.......#....#....#
........#....#..#.....#......#.
.......#..........#......#.....
...............................
..#..#####..#..#..........#.#..
.....#....##................#.#
.................##............
.#...#...#..#...........#...##.
..#..#.#...........#.....##....
.#.......#.....#..##..#.#....#.
..........#.#......##...##.....
........##..#......##...#......
#......................#.......
............#.....#....#.#...#.
#......#..........##..#........
.........#.......#...#.#.......
...........##....#........#....
#........#.....#...#........##.
.#......##......#.##.......#..#
.....#......#.#......#.......#.
.....#.#.........#.............
...........#..#....#.....#.#...
...#............#...#..........
..#..#...#.....................
......#..#...#....#............
.#.#.#........#..#...#.........
..........#........#..#........
..............#...#....#.......
..#....#....##.......#...#.##..
.#.........#...#......#........
..#......#...#.........##.#...#
...#.....#...#..#.............#
.##........#.#.#.............#.
..#.............#..#.#...#....#
#...#.........#......#......#..
.......##..#.#..........#...#..
.......#.............#..#.#....
.#..#....#.#...................
....##...#..#....#..#..........
....#.#............#...........
###........##..#.#..#..........
.#.#.#.......#...........#..#.#
..........##..#.............#..
.#...........#......#.#..#..##.
...###......#.##........#.....#
....#..#..#...#................
...#.....#........#............
....#...#...#..#..##.##.......#
#.......#......#....#.......#..
#.............#...#............
##......#..#...#....##.#...#...
.##....................#....#..
..#.....#....#.#....#......#...
.......#..#..#............#...#
.#.....#.......#..#..#..#......
......##.......................
#..#...#.#.#....#.....#..#.....
...................#...#...#...
........#....##..#....#........
##......#.#......##.###........
.........#...##................
.......#...#...#.......##......
....#.......#......#.........##
....#....#.#..#.....#..........
...........#.......#........#..
..#.........###.#........#.....
.......#...........#.#.....##..
..#...#..#..........#..........
..........#.#....#.............
.##....#........##.............
.............#.#####........#.#
.................##...#........
##...#.#.......##........#.....
.#...#...#..#..#....#....#.....
..#...#........#..#............
##...#.#........#......##.#..##
.##......#..............##.#..#
.........#...#............#...#
....#..#....#...........#......
........#..#....#...##...#.....
..#..............#...#.#.....#.
.#.......#.#.....#..###.......#
...................#.......#...
........##.....#..#.......##...
.....#....................#...#
...#.#....#............#.#.....
#.......#.......#....#.........
..#...............#............
##...#...#...#..............#..
...#..........#..#....##.......
#............##.##......#.#.#..
.#...........#.........#....##.
..##....##.#....#.#.#.##...##.#
........#.#.#.............#....
.#...........#....##...#...#.#.
.##...#.................#......
....#.#..#....................#
.##......#........#..#.........
...#...............#...........
.#.#..##..##.#........#........
...........#....#.#.#......#...
...................#........#.#
..#............#...#.#........#
....#....#.#.##......#...#.....
..................#............
..........................#....
........#......................
......#.#...#.#..##......#.#.#.
.........#...#..#..............
..#.......#..........##..#.....
.........#............#........
......#..#..#...###....#....#..
#..#..............##.###..##..#
.#..................#.....#...#
........#........#........#....
.........#........#.##......#..
..#.....#.#..###...#....#......
..#................##....#.....
..#.#....##.....#......##...#..
...#.......#........##.........
#........#...#.#..........##..#
................#...#.#.....#..
.........#..#..#.#..#.#...#....
##....#...##.........#.#...#.##
....#..#.....##.....#.....##...
................#............#.
..#..#...#.....#......#.....##.
....#.......#...#...#...#..#...
....#..##....#.###.#...#..#....
#..##.....#.....#.##..##...##.#
.............###..........#....
..................#.....###....
..........#....#...#......#....
...#..##.......#......#.#...#..
..#.......................##.#.
..#..#..#....#......#...#...##.
#.............#................
..........#.#.#.........#.#....
.....##..#......##.#...........
.#.#.#.#....#.#...#.....#.#...#
......#.....##..............##.
#..#.......##..##..............
#..#..#................###.....
.....#......#.........#........
#...........#........#.#.......
#........#.#...#....#....###..#
###..#.#...........#.##.....#.#
..#..........#..#............#.
...#....#.......#..#.....###...
.#....#.##.#..###..............
.....#.##.##.......###.##...#.#
..#..##.......###..............
.#.........###..#..............
..................###.....#..#.
#....#....#.........#.....#....
.........#.#..#....#.....#.....
....##.......##.......#.#......
.....#...#.##.....#............
....#.#.#.......#..............
.##..#.#..#.......##...........
....#....##..#.....##.......#.#
.....##....#..#.#........#.....
........#.#.#....#....##...#..#
..#......#.#.#..#.##....#.#.#..
..#...#........#..#..........#.
.........#...................#.
........#.....##..#....#....#..
#..............#..........#....
#........#.#...........#.#.....
..#......................#.#..#
.........#.#.....#.#..........#
......#....#.#.##........#.....
.#....##......##..#...#.......#
..#........#...#.##....#..#.#..
.......#.....#..........#.....#
.........#.#..#.........#....#.
..........#.##.........##..#...
......#.#..#.....#.#..........#
......#.#.#..#..#.#............
...##.#..#..............#....#.
#..........#...................
.#....#..#.#.......#........#..
...#...#......#....#......#....
..#.#.......#.......#.......#.#
...#.#...#........#.....#......
#.......#..#...................
#..#..#.............#..#..#..#.
#.......................#....##
.#.........#....#....#.........
...............#...#..#....#..#
#.....#.#...#.#.....#..........
....##.#..#...#.#....###...#.#.
.................#....#........
####.......##...##.......#.##..
#..#....#....##............#...
..##......#..#........#........
....#..#..........#......#...##
..#.#.............#...........#
#...............#...#.......#.#
#..#.........#.##.#.......#...#
......#.....#.............#...#
......#.##.........##...#......
..#......##.#........#.......#.
#..#.........#.##..............
..#....#...#...#..#.....#.#....
................#.......#......
#.....#..............##....#.##
##.....#...#.#.....#..##...#...
#.#............##..........#..#
..#.##......#..#....#..........
....##.#....#.......##.....#...
......#.#....###...#...........
..................#......#....#
..............##...............
......#..#....#.....#..........
.......#........#...#..........
..#......#......##..#.##..#....
..#.#...#...............#......
....#.#.............#.#......#.
....#.#.....#......#..#.......#
........................#..#...
.................#...........#.
#......#......#.#.#.....##.....
..#....##...#.....##.#.....#..#
....#.........#....#.##.#.#....
..#....###.....................
.....#.#....#......#....##....#
#.......#...#......##.......#..
#....#.........##.....#........
#.....#...........#..#.....#...
.................#.....#..##..#
..#...#......####...##.........
...............................
#........#.....#...............
.#.........#....#.#......##....
...#..........#.........#.#.#.#
......##......#....###........#
.....................#.#.#.....
......#..#..#.......#...#......
...##.#.............#.#.......#
..#.#...#..#....#.....#.....#..
..#..#.....................#..#
........#....#..........#..#...
#.##....#..#.#..#............#.
..............###.............#
.#.#..........#.#....#...#....#
....#..........#.#..#......#...
.........##.#...#..............
..................#.....#.#....
.#....#.......#.##.#.........#.
.##..#...#......#..#...........
.#.........#..........#.#......
#.#......#.#.#.#.......#...#.#.
.......#....#.#......#......#..
...#..#....#.#..#..##...##.....
#.#.#.......#....#.........##..
#..#....#........###....#.#....
....#..#.........#....#...#....
...#.#.#.#..#..##.....#.##.....
.......#.......#...............
#.#.#......##....#.............
...#.##........#.....#...##.#..
...#.#.###..........#.......#..
.....#...#.......#.........#...
............#..#...#..##.......
...#....#..##.##..........#.##.
..................#........#...
....#.##.#.##........#.#.......
.#...........##.....##.......#.
#...#.........#.....##.........
#..#....#.#.........#..........
..#......#.#.#......#.....#..#.
..##......#..............#.....